Relevant_categories_in_Open_Images_Dataset_(by Google):

Dress - dress, wedding dress, little black dress, cocktail dress, dance dress, day dress, bridal party dress
Suit - suit, one-piece swimsuit, infant bodysuit, swimsuit bottom, swimsuit top
Overalls - Overall
tracksuit
sarong
robe - robe
pyjamas
bikini
lingerie - lingerie, lingerie top
mens_swimwear - swimwear
mens_underwear
jumpsuit
bra - sports bra,
panties - panties, underpants
babydoll
coat - trench coat, coat, overcoat
jacket - leather jacket, jacket
blazer - blazer
cardigan - cardigan
sweatshirt - sweatshirt
hoodie - hoodie
sweater - sweater
vest - vest
poncho - poncho
t-shirt - long-sleeved t-shirt, t-shirt
button-down - dress shirt
blouse - blouse
polo - polo shirt, tennis polo
henley
tube
tanktop
jeans - carpenter jeans, jeans
pants - active pants, cargo pants
stockings - stocking
leggings - leggings
socks - sock
shorts - active shorts, shorts
skirt - miniskirt, skirt, dance skirt
shawl
scarf - scarf
boots - work boots
shoes - shoe, running shoe, bicycle shoe, outdoor shoe, tennis shoe, walking shoe, hiking shoe, cross training shoe, bridal shoe, slip-on shoe, athletic shoe, skate shoe, wrestling shoe, oxford shoe
sandals - sandal
bag - tote bag, messenger bag, handbag, hobo bag, shoulder bag
belt - belt, black belt
sarong

others - clothing, latex clothing, baby & toddler clothing, bridal clothing, fur clothing